Bitcoin - BTC
Ethereum - ETH
XRP - XRP
Bitcoin Cash - BCH
EOS - EOS
Stellar - XLM
Litecoin - LTC
Tether - USDT
Cardano - ADA
Monero - XMR
IOTA - IOT
Tron - TRX
Ethereum Classic - ETC
Dash - DASH
NEO - NEO
Binance Coin - BNB
NEM - XEM
VeChain - VET
Tezos - XTZ
ZCash - ZEC
OmiseGo - OMG
Lisk - LSK
QTUM - QTUM
0x - ZRX
Ontology - ONT
Bitcoin Gold - BTG
ByteCoin - BCN
Decred - DCR
Dogecoin - DOGE
Bitshares - BTS
Maker - MKR
DigiByte - DGB
Zilliqa - ZIL
Nano - NANO
ICON Project - ICX
Steem - STEEM
Aeternity - AE
Waves - WAVES
Augur - REP
Basic Attention Token - BAT
Verge - XVG
Siacoin - SC
MOAC - MOAC
Populous - PPT
Bitcoin Diamond - BCD
Bytom - BTM
Pundi X - NPXS
RChain - RHOC
Golem Network Token - GNT
Stratis - STRAT
Status Network Token - SNT
Metaverse - ETP
Hshare - HSR
KuCoin Shares - KCS
Waltonchain - WTC
Mithril - MITH
IOStoken - IOST
Komodo - KMD
Dentacoin - DCN
ChainLink - LINK
Digix DAO - DGD
MaidSafe Coin - MAID
Ardor - ARDR
Huobi Token - HT
Ino Coin - INO
Aion - AION
ZenCash - ZEN
Wanchain - WAN
MonaCoin - MONA
aelf - ELF
FunFair - FUN
Nebulas Token - NAS
Bancor Network Token - BNT
GXShares - GXS
Bitcoin Private - BTCP
Kin - KIN
Mixin - XIN
Cortex - CTXC
Power Ledger - POWR
ReddCoin - RDD
TaTaTu - TTU
Emercoin - EMC
Decentraland - MANA
HoloToken - HOT
ZCoin - XZC
ARK - ARK
Elastos - ELA
Monaco - MCO
PIVX Coin - PIVX
Nxt - NXT
Worldwide Asset eXchange - WAX
KyberNetwork Crystal - KNC
TrueUSD - TUSD
TenX - PAY
QASH - QASH
Loopring - LRC
Nuls - NULS
U.CASH - UCASH
Veritaseum - VERI
CyberMiles - CMT
Bibox Token - BIX
SysCoin - SYS
Polymath Network - POLY
Enigma - ENG
Gas - GAS
Loom Network - LOOM
Theta Token - THETA
Odem - ODE
Substratum Network - SUB
Centrality - CENNZ
Electroneum - ETN
onG.social - ONG
SmartCash - SMART
Nexus - NXS
Dai - DAI
Iconomi - ICN
Factom - FCT
Dent - DENT
Groestlcoin - GRS
Gifto - GTO
TokenPay - TPAY
Byteball - GBYTE
Prizm - PZM
Dignity - DIG
ZClassic - ZCL
Civic - CVC
Santiment - SAN
Skycoin - SKY
Storj - STORJ
Dragonchain - DRGN
WaykiChain - WIC
Matrix AI Network - MAN
Storm - STORM
Scry.info - DDD
Ignis - IGNIS
Ethos - ETHOS
Noahcoin - NOAH
Gnosis - GNO
Fusion - FSN
Crypterium - CRPT
VertCoin - VTC
Salt Lending - SALT
Bread token - BRD
Cube - AUTO
iEx.ec - RLC
Tokenomy - TEN
Request Network - REQ
Nexo - NEXO
Ravencoin - RVN
High Performance Blockchain - HPB
BlockNet - BLOCK
PeerCoin - PPC
Aragon - ANT
Cindicator - CND
Enjin Coin - ENJ
Time New Bank - TNB
Edgeless - EDG
PacCoin - $PAC
BOScoin - BOS
Crypto20 - C20
SafeExchangeCoin - SAFEX
Neblio - NEBL
Nucleus Vision - NCASH
Unobtanium - UNO
FuzeX - FXT
LoyalCoin - LYL
Particl - PART
Eidoo - EDO
Ethfinex Nectar Token - NEC
QuarkChain - QKC
Revain - R
Bitcoin Interest - BCI
Po.et - POE
True Chain - TRUE
Credits - CS
SingularityNET - AGI
SmartMesh - SMT
Quantstamp - QSP
Achain - ACT
Ubiq - UBQ
BridgeCoin - BCO
Bluzelle - BLZ
Streamr DATAcoin - DATA
DeepBrain Chain - DBC
PrimeCoin - XPM
LEOcoin - LEO
Asch - XAS
KickCoin - KICK
Monero Classic - XMC
Bitcore - BTX
Dynamic Trading Rights - DTR
THEKEY - TKY
SirinLabs - SRN
BitcoinDark - BTCD
Wagerr - WGR
BLOCKv - VEE
DigitalNote - XDN
MediShares - MDS
WhiteCoin - XWC
Rock Token - RKT
9*/88 - TEL
ViaCoin - VIA
Genaro Network - GNX
Modum - MOD
Quantum Resistant Ledger - QRL
SONM - SNM
MEDX - MEDX
MinexCoin - MNX
BitBay - BAY
Pillar - PLR
Paypex - PAYX
Ionomy - ION
Bottos - BTO
Ambrosus - AMB
Zeepin - ZPT
Genesis Vision - GVT
DAEX - DAX
Raiden Network - RDN
Einsteinium - EMC2
Ruff - RUFF
NavCoin - NAV
United Traders Token - UTT
Stakenet - XSN
SophiaTX - SPHTX
BurstCoin - BURST
SaluS - SLS
eosDAC - EOSDAC
NagaCoin - NGC
Decent.bet - DBET
Odyssey - OCN
POA Network - POA
Mainframe - MFT
Steem Backed Dollars - SBD
LitecoinCash - LCC
Metal - MTL
TokenClub - TCT
Red Pulse - RPX
Scroll - SCRL
Jibrel Network Token - JNT
Seele - SEELE
SelfKey - KEY
APIS - APIS
CPChain - CPC
Arcblock - ABT
Linda - LINDA
Storiqa Token - STQ
Electra - ECA
SingularDTV - SNGLS
Metronome - MET2
BHPcash Token - BHPC
EthLend - LEND
Soarcoin - SOAR
NANJCOIN - NANJ
STASIS EURS - EURS
Global Currency Reserve - GCR
Legolas Exchange - LGO
Gulden - NLG
Pura - PURA
Universa Token - UTNP
Mothership - MSP
OriginTrail - TRAC
Covesting - COV
Trade.io - TIO
AdEx - ADX
SpankChain - SPANK
IoTeX - IOTX
AirSwap - AST
district0x - DNT
Endor Protocol Token  - EDR2
BABB - BAX
Wings DAO - WINGS
PChain - PAI
OneRoot Network - RNT
MediBloc - MED
ContentBox - BOX
QLC Chain - QLC
IoT Chain - ITC
MobileGo - MGO
Republic Protocol - REN
Mobius - MOBI
Cryptaur - CPT
Hive - HVN
GINcoin - GIN
Internet Node Token - INT
Ternio - TERN
TokenCard - TKN
AeonCoin - AEON
XtraBYtes - XBY
TomoCoin - TOMO
ZMINE Token - ZMN
VITE - VITE
Lykke - LKK
CounterParty - XCP
ATN - ATN
Bitcoin Green - BITG
FeatherCoin - FTC
Harvest Masternode Coin - HC
Lympo - LYM
EDUCare - EKT